Player,Points played total,Offense points played,Defense points played,Offense points won,Defense points won,Touches,Points played with touches,Throws,Catches,Possessions initiated,Assists,Secondary assists,Goals,Turnovers,Thrower errors,Receiver errors,Defensive blocks,Stall outs for,Stall outs against,Total completed throw distance (m),Total completed throw gain (m),Average completed throw distance (m),Average completed throw gain (m),Total caught pass distance (m),Total caught pass gain (m),Average caught pass distance (m),Average caught pass gain (m)
25 Ducky Tewodros,32,0,32,0,5,11,10,9,11,0,0,0,2,0,0,0,0,0,0,66.36,32.71,8.30,4.09,136.44,96.91,12.40,8.81
17 Rufus Caitlin Duffner,82,77,5,48,2,72,44,59,69,3,3,11,13,6,5,1,4,0,0,432.63,146.27,8.01,2.71,895.76,610.35,12.98,8.85
08 PJ Maddi Lang,69,14,55,6,17,86,34,84,81,5,2,3,2,7,7,0,0,0,0,647.78,278.79,8.64,3.72,634.03,57.56,7.83,0.71
41 Avery Mullen,17,0,17,0,10,13,6,12,12,1,0,2,1,0,0,0,1,0,0,100.58,13.82,8.38,1.15,128.48,35.69,10.71,2.97
10 Steph Rupp,78,75,3,54,1,232,74,230,191,41,9,14,2,9,9,0,2,0,0,"2,485.08","1,192.85",11.35,5.45,"1,651.98",291.53,8.65,1.53
00 Eileen Duffner,0,0,0,0,0,0,0,0,0,0,0,0,0,0,0,0,0,0,0,0.00,0.00,0.00,0.00,0.00,0.00,0.00,0.00
27 Connie Chan,100,21,79,11,20,65,37,58,60,5,2,2,7,8,5,3,8,0,0,514.86,167.31,9.71,3.16,815.25,566.29,13.59,9.44
06 Kylie Chesner,74,1,73,1,23,35,23,32,35,0,2,2,3,1,1,0,2,0,0,281.91,131.03,9.09,4.23,441.64,294.55,12.62,8.42
13 Grace Feehan,72,69,3,46,1,54,39,47,51,3,1,5,7,5,4,1,6,0,0,480.18,222.00,11.43,5.29,659.45,500.18,12.93,9.81
23 Marie Zarazoga,21,0,21,0,4,11,6,11,11,0,0,0,0,2,2,0,0,0,0,62.37,11.72,6.93,1.30,112.35,0.76,10.21,0.07
14 Sarah Helding,0,0,0,0,0,0,0,0,0,0,0,0,0,0,0,0,0,0,0,0.00,0.00,0.00,0.00,0.00,0.00,0.00,0.00
07 Annie Phan,57,1,56,1,13,48,18,48,36,12,3,1,0,7,5,2,4,0,0,387.36,117.47,9.01,2.73,330.38,41.01,9.18,1.14
26 Rhea Joshi,56,2,54,2,20,26,17,25,25,1,2,0,1,1,1,0,3,0,0,231.92,82.42,10.08,3.58,298.52,241.17,11.94,9.65
05 Anna Thorn,61,61,0,39,0,142,52,139,106,36,11,4,3,14,14,0,1,0,0,"1,356.18",632.64,10.85,5.06,938.35,254.88,8.85,2.40
82 Claire Schmitt,104,23,81,14,24,190,64,190,117,73,20,4,0,28,27,1,1,0,0,"2,289.11","1,419.18",14.22,8.81,992.89,88.50,8.49,0.76
99 Dana Demmert,48,1,47,0,13,36,19,33,36,0,1,1,3,4,4,0,1,0,0,241.71,80.04,8.95,2.96,506.05,391.36,14.06,10.87
24 Anna Stubbs,41,40,1,27,1,42,22,38,41,1,1,3,4,4,3,1,2,0,0,351.74,105.07,10.05,3.00,502.91,313.29,12.27,7.64
15 Hannah Cheng,76,59,17,36,1,143,52,140,114,29,4,2,3,12,12,0,0,0,0,"1,190.29",330.90,9.37,2.61,"1,046.46",104.19,9.18,0.91
31 Abby Shure,28,28,0,21,0,42,18,37,40,2,5,2,5,6,6,0,1,0,0,314.75,152.70,10.15,4.93,459.26,327.23,11.48,8.18
29 Jade Hostein,85,12,73,8,23,93,41,85,90,3,3,6,8,11,7,4,8,0,0,688.78,114.03,8.95,1.48,943.27,574.87,10.48,6.39
04 Becca Napoli,0,0,0,0,0,0,0,0,0,0,0,0,0,0,0,0,0,0,0,0.00,0.00,0.00,0.00,0.00,0.00,0.00,0.00
21 Sowmya Ragothaman,54,31,23,18,8,81,34,78,67,14,0,5,3,2,2,0,2,0,0,703.10,174.38,9.25,2.29,638.07,188.70,9.52,2.82
44 Lily LeDonne,0,0,0,0,0,0,0,0,0,0,0,0,0,0,0,0,0,0,0,0.00,0.00,0.00,0.00,0.00,0.00,0.00,0.00
11 Letty Ho,8,0,8,0,3,3,1,3,3,0,0,0,0,1,1,0,0,0,0,18.47,-6.93,9.23,-3.46,35.13,27.71,11.71,9.24
88 Catherine Chen,67,64,3,43,1,155,56,153,125,30,11,3,2,16,13,3,4,0,0,"1,424.60",643.94,10.32,4.67,"1,134.10",346.94,9.07,2.78
16 Sasha Baumann,6,6,0,5,0,6,3,5,6,0,0,0,1,0,0,0,1,0,0,36.37,-10.44,7.27,-2.09,101.46,90.58,16.91,15.10
02 Alex Hu,0,0,0,0,0,0,0,0,0,0,0,0,0,0,0,0,0,0,0,0.00,0.00,0.00,0.00,0.00,0.00,0.00,0.00
72 JJ Jarik,83,82,1,51,1,79,53,74,78,1,13,7,5,14,14,0,2,0,0,973.81,736.86,16.23,12.28,"1,071.02",620.32,13.73,7.95
18 Kendra Griesman,64,60,4,37,1,66,40,50,65,1,1,9,16,5,4,1,8,0,0,415.63,101.67,9.04,2.21,"1,051.98",765.48,16.18,11.78
09 Moose Lucy Petersen,36,35,1,22,1,38,22,32,38,0,2,3,6,6,5,1,2,0,0,246.02,77.76,9.46,2.99,540.73,442.50,14.23,11.64
95 Bug Elena Dansdill,5,0,5,0,0,3,2,3,3,0,0,0,0,1,1,0,0,0,0,17.14,-1.99,8.57,-0.99,29.32,20.99,9.77,7.00
12 Lizzie Tilden,39,1,38,0,10,55,14,55,48,7,1,3,0,6,3,3,0,0,0,553.49,309.38,10.64,5.95,416.92,-37.98,8.69,-0.79